Red    Hernandez
Steve   Garza
Mary	Dean
Joseph	Morrison
Benjamin	Chapman
Christine	Fields
Denise	Thomas
Sara	Gibson
Janet	Tucker
Mark	Allen
Willie	Gomez
Steve	Ramirez
Amanda	Martin
Fred	Gonzales
Daniel	Rivera
Margaret	Cruz
Sean	Turner
Harold	Warren
Andrew	Stanley
Joan	Jenkins
Gerald	Ellis
Tina	Garrett
Steve	Gilbert
Ryan	Burke
Keith	Crawford
Marilyn	Anderson
Marie	Duncan
Elizabeth	Jacobs
Jerry	Ryan
Ralph	Lee

